F F F R M F F F R F
F R F F F R F F F F
M F B F R F F M F R
F F F R F F R F F F
R F F F F F F F F F
F F M F R F F F R F
F R F F F F M F F F
M F F F R F F R F F
F F F R F F F F F B
R F F F F F F M F F
